NO ./textures/floor.xpm
SO ./textures/floor2.xpm
WE ./textures/wall.xpm
EA ./textures/wall2.xpm

F ./textures/comun/floor.xpm
C ./textures/comun/pleine-lune.xpm

1111111111
1000000001
1000000001
1000000001
1000000001
1000000001
1000000001
1000000001
1E00000001
1111111111